111111111111111111111111
100000000000000000000001
100000000000000010000001
100000000000000000000001
111111000000011100000001
     1000000001111000001
111111000000001 11000001
100000000000001 11000001
111111111111101 11000001111111111
        1000011111000000000000001
        1N00000000000000000000001
        1111111111111111111111111
