NO ./north.xpm

SO ./south.xpm

WE ./west.xpm

EA ./east.xpm

F 220,100,0
C 400,30,0

111111111111111111111111
100000000000000000000001
1000000000S0000010000001
100000000000000000000001
111111000000011100000001
     1000000001111000001
111111000000001 11000001
100000000000001 11000001
111111111111101 11000001111111111
        1000011111000000000000001
        1000000000000000000000001
        1111111111111111111111111
